1111100101
0001110000
0011000000
0110110000
0100010001
0100000000
0110001000
0011101101
0101100000
1000111111
